███████████████████████████████████████████████████████
█                                                     █
█                                                     █
█                        █                            █
█    ◘                   █                            █
█                        █                            █
█                        █                            █
█                        █                            █
█                                      ☻              █
█                        █                            █
█       ◘                █                            █
█                        █                            █
█                        █                            █
█                        █                            █
█                        █                            █
█        ◘                                            █
█                                                     █
███████████████████████████████████████████████████████