████████████████████████████
█•           ██           •█
█ ████ █████ ██ █████ ████ █
█ ████ █████ ██ █████ ████ █
█ ████ █████ ██ █████ ████ █
█                          █
█ ████ ██ ████████ ██ ████ █
█ ████ ██ ████████ ██ ████ █
█      ██    ██    ██      █
██████ █████ ██ █████ ██████
██████ ██          ██ ██████
██████ ██ ████◘███ ██ ██████
██████ ██ ████◘███ ██ ██████
██████ ██ ████◘███ ██ ██████
█         ████◘███         █
██████ ██ ████████ ██ ██████
██████ ██ ████████ ██ ██████
██████ ██          ██ ██████
██████ ██ ████████ ██ ██████
██████ ██ ████████ ██ ██████
█            ██            █
█ ████ █████ ██ █████ ████ █
█ ████ █████ ██ █████ ████ █
█   ██        ☻       ██   █
███ ██ ██████████████ ██ ███
███ ██ ██████████████ ██ ███
█            ██            █
█ ██████████ ██ ██████████ █
█ ██████████ ██ ██████████ █
█•                        •█
████████████████████████████