███████████████████████████████████████████████████████
█                                                     █
█         •                                   •       █
█                        █                            █
█    ◘                   █                            █
█                        █       █████████            █
█                        █                            █
█                        █                            █
█         ██████████                   ☻              █
█                        █                            █
█       ◘                █                            █
█                        █                            █
█                        █                            █
█                        █                            █
█                        █       ████████             █
█        ◘                                     •      █
█                                                     █
███████████████████████████████████████████████████████